.........................*....S
..........................*....
..........................*....
...............................
....*................*.........
...*...........................
....*................*.........
...*...........................
..*......*.........*......*....
..........................*....
....*................*.........
...*...........................
..*......*................*....
..........................*....
..*......*................*....
....*................*.........
...*...........................
..*......*................*....
..........................*....
....*................*.........
...*...........................
..*......*................*....
..........................*....
..........................*....
....*.....*******.........*....
...*......................*....
..*.......................*....
G.........................*....